%%%%%%%%%%%%%%
%  %  %G  GG %
%%   .  o   .%
%. . .      %%
%            %
%.      %.   %
%    %   P . %
%%  .  % .   %
%     %    %%%
%  o      . %%
%%%%%%%%%%%%%%
