%%%%%%%%%%
%.       %
%  P .  %%
%      . %
%.   .G% %
%  .     %
%%%%%%%%%%
