%%%%%%%%%%%%
%G   PG o  %
%        . %
%.G %..    %
%     %    %
%.         %
%%%%%%%%%%%%
