%%%%%%%%%%%
%  P    o%%
%     G   %
%  o    . %
%o        %
%.      %.%
% %% o.%  %
%   % .  G%
%o.    ..o%
%     %   %
%% ..%   .%
% . .     %
%  oo%   o%
%%%%%%%%%%%
