%%%%%%%%%%%%%%%
%. o  G. .   P%
%  o  .  % . .%
%.G   . o  .  %
%  . ..      .%
%. ...   .  oG%
%.o  %o%.o..% %
%%%%%%%%%%%%%%%
