%%%%%%%%%%%%
%     %%   %
%       . %%
%.    G ..%%
%.%        %
%  .  .    %
% % . .%.. %
%  .% .    %
%  .      .%
%          %
%   .P     %
%%%%%%%%%%%%
