%%%%%%%%%
%....   %
%%Po.   %
%  %.   %
% .     %
%  %..  %
% G    G%
% .    %%
%   %.. %
%       %
% . .%  %
%      .%
%  . o% %
%   %   %
%%%%%%%%%
