%%%%%%%%
% G% % %
% .   .%
%   . .%
%% .  .%
%. %% G%
%   %. %
% .%% %%
% P  . %
%     G%
%o .o. %
%%%%%%%%
