%%%%%%%%%%%%%%
%  % ..   % .%
%.           %
%% o  . P %. %
%    %. %    %
%     G  ..o %
%.G %   %   G%
%  . o.      %
%     o    ..%
%%%%%%%%%%%%%%
