%%%%%%%%
%.   o %
%  % % %
% .    %
%    o %
%G     %
% P   %%
%%%%%%%%
