%%%%%%%%%%%
%  P      %
%  .    % %
%.o%.    .%
%% % o%   %
%      G. %
%         %
%o        %
%.  .     %
%       %.%
% %     o %
%%%%%%%%%%%
