%%%%%%%%%%%%
%      % PG%
%     % %  %
%   .%   G %
%      %. %%
%o%        %
%  o   .   %
%         %%
%    o    %%
%%%%%%%%%%%%
