%%%%%%%
%G %  %
%  .. %
%o. . %
%.    %
% .%  %
%     %
%o   .%
%   % %
%     %
% %.  %
%..  .%
% . %P%
%%%%%%%
