%%%%%%%%%%%%
%.  .    % %
%.G .   Po %
%o      %G %
%.    o  G %
% o.  .%   %
%.   . o   %
%%%%%%%%%%%%
