%%%%%%%%%
%   G % %
% %.o   %
%    . o%
%G      %
%       %
%  %%  P%
%    .o.%
%       %
%%.     %
%%%%%%%%%
